11111111111
1P000100001
101011011C1
100000C0111
10C011000E1
11111111111
